0066666600
0666666660
0888668880
8808888088
4888008884
4444004444
4444004444
0474444740
0447777440
0044444400