XXXXXXXXX0
XXXXXXXX00
XXXXXXX000
XXXXXX0000
XXXXX00000
XXXX000000
XXX0000000
XX00000000
X000000000
