6666666660
0333333333
7777777770
X000000000
X000000000
X000000000
X000000000
X000000000
X000000000